P1,P2,P3,P4,P5,P6,P7,P8,P9,ACTION
1,0,0,1,2,1,1,1,1,1
1,1,0,1,2,0,1,4,1,1
1,0,1,4,2,1,4,1,1,2
1,0,0,1,2,1,4,4,1,1
1,1,1,1,2,0,1,4,1,1
1,1,1,4,2,0,4,1,0,2
1,1,1,4,2,1,1,0,1,2
1,4,1,1,2,1,1,0,1,3
1,4,1,1,2,1,1,0,1,3
1,4,1,1,2,1,1,1,1,3
